....................
....mmm......mm.....
...m...m....m..m....
...m........mm......
...m..........m.....
...m..........mm....
...m...m....m..m....
....mmm......mm.....
....................
....................
....................
....mm...mm...mm....
...m..m.m..m.m..m...
...m..m.m..m.m..m...
.....m....m..m..m...
....m....m...m..m...
...m....m....m..m...
...mmmm.mmmm..mm....
....................
.........h..........