.............c......
.....m...........f..
..s............m....
....m...............
.........mm.........
.....m....m....m....
..........m.........
....m....m..........
.........m....m.....
.....m...mm.........
....................
.............m......
.....m..............
.........m..........
....................
.................m..
....m...............
.......m............
....................
..........h........S