...........c........
....................
....................
....mm..mmmm..mm....
..m......mm......m..
..m......mm......m..
..m......mm......m..
..m......mm......m..
..m.m.m..mm..m.m.m..
.m.....m.mm.m.....m.
m.m..mm......mm..m.m
..m..mmm....mmm..m..
..m..............m..
..m......mm......m..
....m...mmmm...m....
m....m.mmmmmm.m....m
....................
....................
....................
.........h.........S