..m..m...m..........
.mmm.m...m..........
.m.m.mmm.mmm........
....................
....m.m..m..m.m.mmm.
.....m..m.m.m.m.mm..
.....m...m..mmm.m.m.
....................
mmm.mmm.mmm.mmm.mmm.
m.m.m.m.m...m...m...
mmm.mmm..m..mmm..m..
m.m.m.m...m.m.....m.
mmm.m.m.mmm.mmm.mmm.
....................
...m..mmm.mmm.......
..mmm.mm..mm........
..m.m.m.m.mmm.......
....................
....................
.........h..........