...........c........
....................
.....m..............
..............m.....
......m..mm.........
..........m...m.....
..m.......m.........
.........m......m...
...m.....m......m...
.........mm..m......
.....m...m.m........
....................
.......m..m..m.m....
...m................
...mm....m..........
............mm......
.......m.....mm.....
....................
....................
..........h........S